1111111111111
1000000000001
10001111100C1
1000001100001
1P00011000001
10001111100E1
1000000000001
1111111111111
