1111101111111
1001000001
1000011111001
1P0011E00V001
1111111111111
