1111101111111
10010000000C1
1000011111001
1P0011E00V001  0
1111111111111
