1111111111111
1000000000001
10001100100C1
1000111010001
1P00101110001
10001001100E1
1000000000001
1111111111111
